g0 g0 g0 g0 g0 g0 g0 g0 g0 g0 g0 g0 g0 g0 g0 g0 g0 g0 g0 g0 g0
g0 g0 g0 g0 g0 g0 g0 g0 m0 m0 m0 m0 m0 g0 g0 g0 g0 g0 g0 g0 g0
g0 g0 g0 g0 m0 m0 m0 m0 m0 m0 m0 m0 m0 m0 m0 m0 m0 g0 g0 g0 g0
g0 g0 g0 g0 m0 m0 m0 m0 m0 m0 m0 m0 m0 m0 m0 m0 m0 g0 g0 g0 g0
g0 g0 g0 m0 m0 m0 m0 m0 m0 m0 m0 m0 m0 m0 m0 m0 m0 m0 g0 g0 g0
g0 g0 g0 m0 m0 m0 m0 m0 m0 f0 f0 f0 m0 m0 m0 m0 m0 m0 g0 g0 g0 
g0 g0 m0 m0 m0 m0 m0 m0 m0 r0 r0 r0 m0 m0 m0 m0 m0 m0 m0 g0 g0
g0 g0 m0 m0 m0 m0 m0 m0 m0 r0 r0 r0 m0 m0 m0 m0 m0 m0 m0 g0 g0
g0 g0 m0 m0 m0 m0 m0 m0 m0 r0 r0 r0 m0 m0 m0 m0 m0 m0 m0 g0 g0
g0 g0 m0 m0 t0 t0 t0 t0 t0 f0 f0 f0 t0 t0 t0 t0 t0 m0 m0 g0 g0
g0 g0 m0 m0 m0 t0 t0 t0 t0 f0 f0 f0 t0 t0 t0 t0 m0 m0 m0 g0 g0
g0 g0 m0 m0 m0 m0 t0 t0 t0 f0 f0 f0 t0 t0 t0 m0 m0 m0 m0 g0 g0
g0 m0 m0 m0 m0 m0 m0 m0 m0 r0 r0 r0 m0 m0 m0 m0 m0 m0 m0 m0 g0
g0 m0 m0 m0 m0 m0 m0 m0 m0 r0 r0 r0 m0 m0 m0 m0 m0 m0 m0 m0 g0
g0 m0 m0 m0 m0 m0 m0 m0 m0 r0 r0 r0 m0 m0 m0 m0 m0 m0 m0 m0 g0
g0 g0 m0 m0 m0 m0 m0 m0 m0 r0 r0 r0 m0 m0 m0 m0 m0 m0 m0 g0 g0
g0 m0 m0 m0 m0 m0 m0 m0 m0 r0 r0 r0 m0 m0 m0 m0 m0 m0 m0 m0 g0
g0 m0 m0 m0 m0 m0 m0 m0 m0 r0 r0 r0 m0 m0 m0 m0 m0 m0 m0 m0 g0
g0 m0 m0 m0 m0 m0 m0 m0 m0 r0 r0 r0 m0 m0 m0 m0 m0 m0 m0 m0 g0
g0 g0 m0 m0 m0 m0 m0 m0 m0 r0 r0 r0 m0 m0 m0 m0 m0 m0 m0 g0 g0                
g0 m0 m0 m0 m0 m0 m0 m0 m0 r0 r0 r0 m0 m0 m0 m0 m0 m0 m0 m0 g0
g0 m0 m0 m0 m0 m0 m0 m0 m0 r0 r0 r0 m0 m0 m0 m0 m0 m0 m0 m0 g0                                                    
g0 m0 m0 m0 m0 m0 m0 m0 m0 r0 r0 r0 m0 m0 m0 m0 m0 m0 m0 m0 g0
g0 g0 m0 m0 m0 m0 m0 m0 m0 r0 r0 r0 m0 m0 m0 m0 m0 m0 m0 g0 g0
g0 m0 m0 m0 m0 m0 m0 m0 m0 r0 r0 r0 m0 m0 m0 m0 m0 m0 m0 m0 g0  
g0 m0 m0 m0 m0 m0 m0 m0 m0 r0 r0 r0 m0 m0 m0 m0 m0 m0 m0 m0 g0
g0 m0 m0 m0 m0 m0 m0 m0 m0 r0 r0 r0 m0 m0 m0 m0 m0 m0 m0 m0 g0
g0 g0 m0 m0 m0 m0 m0 m0 m0 r0 r0 r0 m0 m0 m0 m0 m0 m0 m0 g0 g0
g0 m0 m0 m0 m0 m0 m0 m0 m0 r0 r0 r0 m0 m0 m0 m0 m0 m0 m0 m0 g0 
g0 m0 m0 m0 m0 m0 m0 m0 m0 r0 r0 r0 m0 m0 m0 m0 m0 m0 m0 m0 g0
g0 m0 m0 m0 m0 m0 m0 m0 m0 r0 r0 r0 m0 m0 m0 m0 m0 m0 m0 m0 g0
g0 g0 m0 m0 m0 m0 m0 m0 m0 r0 r0 r0 m0 m0 m0 m0 m0 m0 m0 g0 g0
g0 m0 m0 m0 m0 m0 m0 m0 m0 r0 r0 r0 m0 m0 m0 m0 m0 m0 m0 m0 g0
g0 m0 m0 m0 m0 m0 m0 m0 m0 r0 r0 r0 m0 m0 m0 m0 m0 m0 m0 m0 g0
g0 m0 m0 m0 m0 m0 m0 m0 m0 r0 r0 r0 m0 m0 m0 m0 m0 m0 m0 m0 g0
g0 g0 m0 m0 m0 m0 m0 m0 m0 r0 r0 r0 m0 m0 m0 m0 m0 m0 m0 g0 g0
g0 m0 m0 m0 m0 m0 m0 m0 m0 r0 r0 r0 m0 m0 m0 m0 m0 m0 m0 m0 g0
g0 m0 m0 m0 m0 m0 m0 m0 m0 r0 r0 r0 m0 m0 m0 m0 m0 m0 m0 m0 g0
g0 m0 m0 m0 m0 m0 m0 m0 m0 r0 r0 r0 m0 m0 m0 m0 m0 m0 m0 m0 g0
g0 g0 m0 m0 m0 m0 m0 m0 m0 r0 r0 r0 m0 m0 m0 m0 m0 m0 m0 g0 g0
g0 g0 m0 m0 m0 m0 m0 m0 m0 r0 r0 r0 m0 m0 m0 m0 m0 m0 m0 g0 g0
g0 g0 g0 m0 m0 m0 m0 m0 m0 r0 r0 r0 m0 m0 m0 m0 m0 m0 g0 g0 g0
g0 g0 g0 g0 n0 n0 n0 n0 n0 n0 n0 n0 n0 n0 n0 n0 n0 g0 g0 g0 g0
g0 g0 g0 g0 n0 n0 n0 n0 n0 n0 n0 n0 n0 n0 n0 n0 n0 g0 g0 g0 g0
g0 g0 g0 g0 n0 n0 n0 n0 n0 n0 n0 n0 n0 n0 n0 n0 n0 g0 g0 g0 g0
g0 g0 g0 g0 n0 n0 n0 n0 n0 n0 n0 n0 n0 n0 n0 n0 n0 g0 g0 g0 g0